4 0 0 0 0 0 0 0 9
3 2 9 4 7 0 8 5 6
7 0 0 0 5 6 0 0 3
8 0 2 6 0 9 7 0 0
0 4 0 0 0 0 0 0 8
9 7 3 5 4 0 6 1 0
1 0 7 0 0 0 0 0 0
0 9 4 3 1 2 5 0 7
0 5 0 0 9 0 3 0 1
