0 5 2 0 0 1 9 0 0
8 0 0 9 0 0 0 5 0
0 6 0 0 8 0 7 4 1
7 2 0 0 5 6 8 0 0
0 0 0 0 0 0 0 0 3
1 9 0 0 0 0 5 7 0
0 0 1 4 3 0 0 6 0
0 0 0 7 6 2 3 0 5
0 0 0 0 0 2 0 0 0
