0 7 4 0 3 5 6 8 1
0 2 0 0 0 9 3 0 4
5 0 1 8 4 6 0 0 0
0 0 5 0 2 0 8 9 7
0 0 0 5 7 1 4 3 0
7 0 6 3 0 0 2 0 0
8 5 3 4 6 7 1 2 0
0 9 7 1 0 2 0 6 3
0 6 0 9 0 0 0 0 0
