0 0 0 0 1 0 0 0 0
0 0 0 0 0 0 0 0 3
0 0 9 3 8 7 5 4 0
5 0 0 7 0 0 9 0 3
0 0 0 5 0 3 2 0 1
0 0 2 0 0 6 4 5 0
8 0 0 2 7 1 3 0 0
3 0 0 0 6 9 0 0 2
0 0 0 0 0 0 0 1 0
